gonggongjijian	guojishehui	guoji
qitashenghuo	guojishenghuo	guoji
guojitiyu	guojishehui	guoji
guojijunshi	guojijunshi	guoji
guojiwaijiao	guojishizheng	guoji
guojiyule	guojishehui	guoji
guojiwenyi	guojishehui	guoji
guojikeji	guojishehui	guoji
guojijinrong	guojishehui	guoji
qiyidongwu	yiguoqiwen	guoji
yiguofengqing	yiguoqiwen	guoji
kongbuxiji	waiguoneizheng	guoji
qingganhuati	guojishenghuo	guoji
yiwaishigu	guojishehui	guoji
huanjierenmian	waiguoneizheng	guoji
gaigezhengce	guojishizheng	guoji
zhengzhichouwen	guojishizheng	guoji
zhengzhirenwudongtai	guojishizheng	guoji
zhengnengliangxinwen	guojishenghuo	guoji
wuzhuangyundong	waiguoneizheng	guoji
minshenghuati	guojishenghuo	guoji
shezhongshijian	guojishehui	guoji
shehuiluanxiang	guojishenghuo	guoji
keyankekao	guojishehui	guoji
ziranjingguan	yiguoqiwen	guoji
ziranzaihai	guojishehui	guoji
jingfeifanzui	guojishehui	guoji
quwenyishi	yiguoqiwen	guoji
jihuiyouxing	waiguoneizheng	guoji
lingtuzhuquan	guojishizheng	guoji
guojiqita	guojiqita	guoji